###############
#     @       #
#     *       #
#             #
#             #
#             #
#             #
#             #
#             #
#             #
#             #
#             #
#    x        #
#             #
###############
